7 8
#######
#     #
#     #
#. #  #
#. $$ #
#.$$  #
#.#  @#
#######
