7 8
### ###
#.###.#
# #  .#
# $$ @#
#  $  #
#  #  #
#  ####
####   
