10 9
  #####   
 ##   #   
##  #.##  
# @ $  #  
# * *  ###
##*#*#   #
 #       #
 ##  #####
  ####    
