22 11
    #####             
    #   #             
    #$  #             
  ###  $###           
  #  $  $ #           
### # ### #     ######
#   # ### #######  ..#
# $  $             ..#
##### #### #@####  ..#
    #      ###  ######
    ########          
