7 7
#######
#  .@ #
# #.# #
#   $ #
#.$$ ##
#  ### 
####   
