7 7
  #####
###@ .#
# $ #.#
#  $$ #
#.  # #
#   $.#
#######
